    R 640      480       
 NO  ./pics/eagle.xpm
 SO ./pics/redbrick.xpm
WE ./pics/wood.xpm

EA ./pics/greystone.xpm

S ./pics/barrel.xpm
F 0,50,100
C 255,255,255

        1111111111111111111111111
        1000000000110000000000001
        1011000001110000000000001
        1001000000000000000000001
111111111011000001110222222222221
100000000011000001110111110111111
11110111111111211100000010001
11110111111111211101010010001
11000000110101211100000010001
12222222222222221100000010001
10022222222222221101010010001
1100N00111010101111101111000011
10010111 1110101 101111010001
11111111 1111111 111111111111
1
