R 640 480
NO ./pics/eagle.xpm
SO ./pics/redbrick.xpm
WE ./pics/wood.xpm
EA ./pics/greystone.xpm

S ./pics/barrel.xpm
F 0,0,255
C 255,255,255

1111111111111111111
1000000000001212221
1000000000000222221
1000010100001010101
1000001000000N00001
1000010100000000001
1000000000000000001
1000000000000000001
1111111111111111111
