R 1200 900
NO ./pics/mossy.xpm
SO ./pics/redbrick.xpm
WE ./pics/wood.xpm
EA ./pics/greystone.xpm

S ./pics/barrel.xpm
F 0,50,100
C 255,255,255

        1111111111111111111111111
        1000000000110000000000001
        1011000001110000000000001
        1001000000000000000000001
111111111011000001110222222222221
100000000011000001110111110111111                   
11110111111111211100000010001
11110111111111211101010010001
11000000110101211100000010001
122000000000000001100000010001
10000000000000001101010010001
1100N001110101011111011110001
10010111 1110101 101111010001
11111111 1111111 111111111111

