R 120 90
NO ./pics/eagle.xpm
SO ./pics/redbrick.xpm
WE ./pics/wood.xpm
EA ./pics/greystone.xpm

S ./pics/barrel.xpm
F 0,50,100
C 255,255,255

11111
10001
10N01
10001
11111
