R 1200 900
NO ./pics/eagle.xpm
SO ./pics/redbrick.xpm
WE ./pics/wood.xpm
EA ./pics/greystone.xpm

S ./pics/barrel.xpm
F 0,50,100
C 255,255,255

   1111     1111     1111
   1001     1001     1001
   1001     1001     1001
   1001111111001111111001
1111020202020202020202021111
1000202020202020202020202001
1000020202020202020202020001
1111202020202020202020201111
   1001111111001111111001
   1001     1001     1001
   1N01     1001     1001
   1111     1111     1111
